000000000000000000000000000000000000000000000000000000000n
000000000000000000000000000000000000000000000000000000000n
000000000000000000000000000000000000000000000000000000000n
000000000000000000000000000000000000000000000000000000000n
000000000000000000000000000000000000000000000000000000000n
000000000000000000000000000000000000000000000000000000000n
000000000000000000000000000000000000000000000000000000000n
000000000000000000000000000000000000000000000000000000000n
000000000000000000000000000000000000000000000000000000000n
000000000000000000000000000000000000000000000000000000000n
000000000000000000000000000000000000000000000000000000000n
0000000000000000000000############00000000000000000000000n
0000000000000000000000############00000000000000000000000n
00000000000000000000#0############00000000000000000000000n
0000000000000000000000############00000000000000000000000n
0000000000000000000000############00000000000000000000000n
000000000000000000000#############00000000000000000000000n
000000000000000000000000000000000000000000000000000000000n
000000000000000000000000000000000000000000000000000000000n
#########################################################
